20
8
    .. .  . ..
   ######   .    .
 . #. . #  .  .  ..
.. # .. #    .   ..
   ### ##.    .. .
.  .   . ..    ####
.  .    .  ... #  .
           .   #  X